Hayes|Cruz|dui@aliquetsem.org|
Addison|Mcdonald|consectetuer.adipiscing.elit@Duissit.co.uk|
Cheryl|Pitts|tortor.dictum.eu@cursus.edu|
Rae|Aguilar|semper.dui.lectus@dui.com|
Zachery|Peterson|vitae@vel.com|
Iola|Peck|dapibus.ligula@fringillaporttitor.co.uk|
Palmer|Colon|Donec.tempus@arcuVestibulumut.org|
Erica|Mullen|ridiculus.mus@aptenttacitisociosqu.edu|
Raya|Mcdaniel|Nunc@porttitorerosnec.net|
Sigourney|Short|ipsum.Donec@variusNam.com|
Rafael|Flynn|sollicitudin.a.malesuada@nibh.edu|
Maryam|Jordan|euismod@sedturpis.org|
Colt|Strong|Suspendisse.commodo.tincidunt@eget.org|
Colt|Marquez|magna.malesuada.vel@mi.org|
Avye|Glass|nec.urna.suscipit@fringilla.edu|
Felicia|Atkins|consectetuer.ipsum.nunc@urnaNullamlobortis.co.uk|
Amena|Joyner|non.magna@quis.com|
Morgan|Best|arcu.Vivamus@temporestac.org|
McKenzie|Shaw|ridiculus@variuset.com|
Willa|Hurley|id.ante@metus.net|
Quintessa|Noel|ante@porttitorvulputate.co.uk|
Sandra|Slater|Cras.convallis@etmagna.edu|
Noelani|Bishop|Donec@urna.net|
Geoffrey|Massey|dui.nec@Duissitamet.net|
Orlando|Cameron|elementum.lorem@arcuVestibulumante.com|
Latifah|Landry|urna.Nunc.quis@vitae.com|
Cynthia|Stone|mauris.sagittis.placerat@elementum.org|
Jacob|Skinner|Aliquam.nec@ridiculusmusProin.co.uk|
Karleigh|Roth|dictum.eu.placerat@nislMaecenas.net|
Todd|Bailey|ut@enimdiamvel.org|
Cathleen|Kelley|Aliquam@neceuismod.org|
Colleen|Drake|Sed.eget.lacus@aaliquet.com|
Richard|Mcdaniel|nunc.sit@semperegestasurna.ca|
Callum|Doyle|consectetuer@at.co.uk|
Kenyon|Cotton|ac@lacusUtnec.org|
Astra|Nunez|tincidunt.tempus.risus@doloregestas.co.uk|
Clarke|Hale|elit.Curabitur@nonquam.co.uk|
Gray|Graves|ac@estconguea.edu|
Zahir|Eaton|per.conubia@aliquetlobortisnisi.edu|
Ashely|Hensley|Nulla.eu.neque@vulputate.edu|
Rebekah|Merrill|tellus@Pellentesquehabitant.org|
Roanna|Compton|ornare.Fusce@feugiat.co.uk|
Heidi|Ewing|sed.est.Nunc@atvelit.net|
Mari|Talley|amet.diam@magna.ca|
Nerea|Mcdowell|consectetuer@ultricesVivamus.ca|
Lila|Black|vitae.erat.Vivamus@elitEtiamlaoreet.edu|
Rhiannon|Ramos|commodo.auctor.velit@nonquamPellentesque.com|
Jamal|Joseph|Nunc.ut@etrisus.co.uk|
Jarrod|Forbes|orci.lacus@sedhendrerita.org|
Quin|Noel|Nulla.aliquet@placerat.org|
Ezra|Cannon|quis.massa@nisiMaurisnulla.co.uk|
Keiko|Cote|adipiscing@aliquamenimnec.net|
Randall|Martinez|est.mollis.non@sagittissemper.org|
Igor|Acosta|arcu.Sed.et@congueelit.org|
Ava|Lancaster|et.pede.Nunc@lorem.net|
Kuame|Austin|In.at@sit.co.uk|
Minerva|Gallegos|habitant@nislNulla.com|
Jermaine|Snow|orci@Donec.edu|
Nehru|Bell|Maecenas@estNuncullamcorper.co.uk|
Baxter|Osborne|Nulla@adipiscingfringilla.edu|
Octavia|Vang|vestibulum.Mauris@sitamet.edu|
Aristotle|Carney|Nulla.tempor.augue@temporaugue.org|
Connor|Stark|massa.Quisque.porttitor@lacus.edu|
Brendan|Huffman|nibh.sit.amet@ligulaNullamenim.edu|
Edan|Russo|ac.turpis@euismodac.co.uk|
Dorian|Mckinney|ante.ipsum@Integeraliquamadipiscing.co.uk|
Stephen|Swanson|elit.pharetra.ut@nondui.net|
Genevieve|Colon|est.Nunc@ultriciesadipiscing.edu|
Karleigh|Hull|in.sodales@nequeNullamut.net|
Rana|Collins|bibendum@varius.org|
Chiquita|Whitfield|senectus.et@est.org|
Clinton|Barnes|lectus.rutrum@quisaccumsanconvallis.ca|
Jerry|Lowery|eget.laoreet.posuere@tincidunt.org|
Andrew|Hess|facilisi.Sed.neque@ultriciesornareelit.co.uk|
Kimberley|Mcfarland|a@gravidamauris.com|
Zachary|Moore|eget.tincidunt.dui@nequesedsem.net|
Karen|Simon|montes.nascetur.ridiculus@Donec.edu|
Mari|Morrow|quis@egetipsumDonec.co.uk|
Idona|Hubbard|nulla.Donec@cubiliaCuraeDonec.ca|
Jeanette|Roberts|mauris.blandit@arcu.net|
Kellie|Byers|aliquet@consectetueradipiscing.org|
Lee|Burns|iaculis.aliquet@mollisInteger.edu|
Cameron|Sharpe|lorem.tristique.aliquet@urnasuscipit.com|
Ray|Kirk|erat@velit.co.uk|
Georgia|Ballard|elementum.sem@scelerisque.edu|
Brett|Sutton|scelerisque.lorem.ipsum@necleoMorbi.org|
Kaseem|Vargas|iaculis@Nullamfeugiatplacerat.net|
Vladimir|Orr|accumsan.laoreet.ipsum@mauris.com|
Jelani|Mcbride|fermentum.convallis.ligula@aliquet.ca|
Tashya|Gill|orci.tincidunt.adipiscing@pretiumetrutrum.com|
Rama|Mccullough|tellus@bibendumullamcorper.edu|
Igor|Mooney|Sed@vehiculaetrutrum.net|
Marny|Graham|lacus@milorem.ca|
Aphrodite|Osborne|Curabitur.massa.Vestibulum@eueros.co.uk|
Colin|Reese|eu@elit.org|
Cynthia|Madden|ut.cursus.luctus@utipsumac.org|
Jessamine|Townsend|porttitor@adipiscingelitEtiam.net|
Vivien|Davis|Suspendisse.tristique@enimCurabiturmassa.net|
Dante|Hammond|et.arcu.imperdiet@euduiCum.ca|
Nehru|Moss|vel.turpis@condimentum.com|
